10
90
50
M.............M..................M.........................................M.............M
M.............M..................M.........................................M.............M
M.............MMM................M......................f................MMM.............M
...............f........f..................x..................f...........................
.................................f......MMMMMMM....x...................f..................
.......................MM.........................MMMMMMMM................................
.....................MMMM......x...................................x......................
MMMMMMMMMMMMMMMMMMMMMMMMM..MMMMMMMMMMM.....................MMMMMMMMMMMMMM..MMMMMMMMMMMMMMM
..........................................................................................
..........................................................................................